levels
##################
#............X...#
#.......----.....#
#....----...----.#
#...........----.#
#.----...----....#
##################